OOOOOOOOOOOOOOOOOOOOOOOOOOOOOOOOOOOOOOOO
OOOOOOOOOOOOOOOOOOOOOOOOOOOOOOOOOOOOOOOO
OOXXXXXXXXXXXXXXXXXXXXXXXXXXXXXXXXXXXXOO
OOXXXXXXXXXXXXXXXXXXXXXXXXXXXXXXXXXXXXOO
OOXXXXXXXXXXXXXXXXXXXXXXXXXXXXXXXXXXXXOO
OOXXXXXXXXXXXXXXXXXXXXXXXXXXXXXXXXXXXXOO
OOXXXXOOOOOOOOOOOOOOOOOOOOOOOOOOOOXXXXOO
OOXXXXOOOOOOOOOOOOOOOOOOOOOOOOOOOOXXXXOO
OOXXXXOOOOOOOOOOOOOOOOOOOOOOOOOOOOXXXXOO
OOXXXXOOOOOOOOOOOOOOOOOOOOOOOOOOOOXXXXOO
OOXXXXOOOOOOOOOOOOOOOOOOOOOOOOOOOOXXXXOO
OOXXXXOOOOOOOOOOOOOOOOOOOOOOOOOOOOXXXXOO
OOXXXXXXXXXXXXXXXXOOOOXXXXXXXXXXXXXXXXOO
OOXXXXXXXXXXXXXXXXOOOOXXXXXXXXXXXXXXXXOO
OOXXXXXXXXXXXXXXXXOOOOXXXXXXXXXXXXXXXXOO
OOXXXXXXXXXXXXXXXXOOOOXXXXXXXXXXXXXXXXOO
OOOOOOOOOOOOOOXXXXOOOOXXXXOOOOOOOOOOOOOO
OOOOOOOOOOOOOOXXXXOOOOXXXXOOOOOOOOOOOOOO
OOOOOOOOOOOOOOXXXXOOOOXXXXOOOOOOOOOOOOOO
OOOOOOOOOOOOOOXXXXOOOOXXXXOOOOOOOOOOOOOO
OOXXXXXXXXXXXXXXXXOOOOXXXXXXXXXXXXXXXXOO
OOXXXXXXXXXXXXXXXXOOOOXXXXXXXXXXXXXXXXOO
OOXXXXXXXXXXXXXXXXOOOOXXXXXXXXXXXXXXXXOO
OOXXXXXXXXXXXXXXXXOOOOXXXXXXXXXXXXXXXXOO
OOXXXXOOOOOOOOOOOOOOOOOOOOOOOOOOOOXXXXOO
OOXXXXOOOOOOOOOOOOOOOOOOOOOOOOOOOOXXXXOO
OOXXXXOOOOOOOOOOOOOOOOOOOOOOOOOOOOXXXXOO
OOXXXXOOOOOOOOOOOOOOOOOOOOOOOOOOOOXXXXOO
OOXXXXOOOOOOOOOOOOOOOOOOOOOOOOOOOOXXXXOO
OOXXXXOOOOOOOOOOOOOOOOOOOOOOOOOOOOXXXXOO
OOXXXXXXXXXXXOOXXXXXXXXXXOOXXXXXXXXXXXOO
OOXXXXXXXXXXXOOXXXXXXXXXXOOXXXXXXXXXXXOO
OOXXXXXXXXXXXOOXXXXXXXXXXOOXXXXXXXXXXXOO
OOXXXXXXXXXXXOOXXXXXXXXXXOOXXXXXXXXXXXOO
OOOOOOOOOXXXXOOXXXXXXXXXXOOXXXXOOOOOOOOO
OOOOOOOOOXXXXOOXXXXXXXXXXOOXXXXOOOOOOOOO
OOOOOOOOOXXXXOOXXXXXXXXXXOOXXXXOOOOOOOOO
OOOOOOOOOXXXXOOXXXXXXXXXXOOXXXXOOOOOOOOO
OOOOOOOOOXXXXOOXXXXXXXXXXOOXXXXOOOOOOOOO
OOOOOOOOOXXXXOOXXXXXXXXXXOOXXXXOOOOOOOOO
